1111111111111111111111111
1000E00000000000000000001
1000000P00000010000000001
1000000000000000000000001
100E00CC0000000000C000001
1000000001000000000E00001
1000000000000000000000001
1111111111111111111111111
