1111111111111111111111111
1000000000000000000000001
100P000000000010000000001
1000000C00000000000000001
1000000000000000000000001
1000000001000000000E00001
1000000000000000000000001
1111111111111111111111111
