1111111111111111111111111
1000E00000P0000000000C001
1111111111111111111111111
